NO ./textures/brick.png
SO ./textures/eagle.png
WE ./textures/greystone.png
EA ./textures/bluestone.png

F 194,178,128
C 135,206,235

11111111111111111111111111111111111111111111111111
10000000000100000000000000000000000000000000000001
10000000000100000000000000000000000000000000000001
10000000000100000000000000000000100000000000000001
10000000000100000000000000000000100000000000000001
10000000000100000000000000000000100000000000000001
10000000000100000000000000000000100000000000000001
10000000000111111111111111111111100000000000000001
100000000000000000000N0000000000000000000000000001
10000000000000000000000000000000000000000000000001
10000000000000000000000000000000000000000000000001
10000000000000000000000000000000000000000000000001
10000000000000000000000000000000000000000000000001
10000000000000000000000000000000000000000000000001
10000000000000000000000000000000000000000000000001
10000000000000000000000000000000000000000000000001
10000000000000000111100000000000000000000000000001
100000000000000001  100000000000000000000000000001
100000000000000001  100000000000000000000000000001
10000000000000000111100000000000000000000000000001
10000000000000000000000000000000000000000000000001
10000000000000000000000000000000000000000000000001
10000000000000000000000000000000000000000000000001
10000000000000000000000000000000000000000000000001
10000000000000000000000000000000000000000000000001
11111111111111111111111111111111111111111111111111