NO ./textures/brick.png
SO ./textures/eagle.png
WE ./textures/greystone.png
EA ./textures/minecraft-bee.png

F 194,178,128
C 135,206,235

11111111111111111111111111111111111111111111111111
10000000000100000000000000000000000000000000000001
10000000000100000000000000000000000000000000000001
10000000000100000000011011111111100000000000000001
10000000000100000000000000000000100000000000000001
10000000000100000000000000000000100000000000000001
10000000000100000000000000000000100000000000000001
10000000000111111111111111111111100000000000000001
10000000000000000000000000000000000000000000000001
10000000000000000000000000000000000000000000000001
10000011100000000000000000000000000000000000000001
1000001110000000000000N000000000000000000000000001
10000011100000000000000000000000000000000000000001
10000000000000000000000000000000000000000000000001
10000000000000011111111111000000000000000000000001
10000000000000010000000000000000000000000000000001
10000000000000100111100000000000000000000000000001
100000000000010001  100000000000000000000000000001
100000000000100001  100000000000000000000000000001
10000000000100000111100000000000000000000000000001
10000000001000000000000000000000000000000000000001
10000000010000000000000000000000000000000000000001
10000000100000000000000000000000000000000000000001
10000001000000000000000000000000000000000000000001
10000010000000000000000000000000000000000000000001
11111111111111111111111111111111111111111111111111