NO ./textures/brick.png
SO ./textures/eagle.png
WE ./textures/greystone.png
EA ./textures/minecraft-bee.png

F 194,178,128
C 135,206,235

11111111111111111111111111111111111111111111111111
10000000000100000000000000000001001010011100111111
10010001001100000000000000000000000000001100111101
10010001100100000000011011111111100000000000000101
11111111001100000000011000100000100000000100011101
1   1000001000000000010001100101000000000100010001
11111100000100000000000000000100100000000100011011
10000100000111111111111111111111100000000111110001
10001100000000000000000000000000000000000000000001
10000000000000000000000000000000000000000000000001
10000011100000000000000000000000000000000000000001
1000001110000000000000N000000000000000000000000001
10000011100000000000000000000000000000000000000001
10000000000000000000000000000000000000000000000001
10000000000000011111111111111111100000000000000001
10000000000000110000000000000000100000000000000001
10000000000001100111100000000000100000000000000001
100000000000110001  100000000000100000000000000001
100000000001100001  100000000000100000000000000001
10000000000110000111100000000000100000000000000001
10000000001001000000000000000000100000000000000001
10000000010000100000000000000000100011111111111111
10000000100000010000000000000000000000011111100001
10000000000000001000000000000000001111010000100001
10000010000000000000000000000000000000000000000001
11111111111111111111111111111111111111111111111111