NO      ./textures/brick.png
SO ./textures/eagle.png
WE ./textures/greystone.png
EA ./textures/bluestone.png

F 220,100,0
C 225,30,0

        1111111111111111111111111
        1000000000110000000000001
        1011000001110000000000001
        1001000000000000000000001
111111111011000001110000000000001
100000000011000001110111111111111
11110111111111011100000010001
111101111111110111010100100011
110000001101011011100000010001
10000W000001110001100000010001
100000000000010001101010010001
1100000111010101111101111000111
11110111 1110101 101111010001
11111111 1111111 111111111111