NO      ./textures/brick.png
SO ./textures/eagle.png
WE ./textures/greystone.png
EA ./textures/bluestone.png

F 220,100,0


afdfsd
C 225,30,0

C 225,30,0


11111111
111111N1
11111111
1111111
1111111